Ac,Date,Transaction,Transaction_amount,Transaction_Type,Balance
277917580,2017-01-04,Salary,35379,D,204995
277917580,2017-01-09,Fuel,24499,W,180496
277917580,2017-01-09,Salary,29118,D,209614
277917580,2017-01-14,Other,17333,W,192281
277917580,2017-01-22,Rent-payment,35500,W,156781
277917580,2017-01-29,Fuel,48913,W,107868
277917580,2017-01-30,Fuel,1217,W,106651
277917580,2017-02-07,Bank-transfered,37749,W,68902
277917580,2017-02-08,Incentive,3177,D,72079
277917580,2017-02-11,Salary,7656,D,79735
277917580,2017-02-17,Incentive,40022,D,119757
277917580,2017-02-25,Friend,1486,D,121243
277917580,2017-02-27,Fuel,17388,W,103855
277917580,2017-03-07,Other,6755,D,110610
277917580,2017-03-19,Incentive,39604,D,150214
277917580,2017-03-26,Other,9696,D,159910
277917580,2017-04-02,Fuel,7280,W,152630
277917580,2017-04-04,Other,18584,D,171214
277917580,2017-04-17,Incentive,29934,D,201148
277917580,2017-04-23,Other,34609,W,166539
277917580,2017-04-26,Other,26228,D,192767
277917580,2017-05-02,Other,14241,W,178526
277917580,2017-05-04,Online-Shopping,31576,W,146950
277917580,2017-05-14,Incentive,15348,D,162298
277917580,2017-05-18,Credit-bill,12980,W,149318
277917580,2017-06-08,Incentive,19698,D,169016
277917580,2017-06-14,Credit-bill,34895,W,134121
277917580,2017-06-16,Rent-payment,25177,W,108944
277917580,2017-06-18,Friend,18298,D,127242
277917580,2017-06-20,Online-Shopping,24204,W,103038
277917580,2017-07-07,Fuel,32433,W,70605
277917580,2017-07-19,Rent-payment,8172,W,62433
277917580,2017-07-22,Credit-bill,9466,W,52967
277917580,2017-07-26,Other,12359,W,40608
277917580,2017-08-07,Incentive,47128,D,87736
277917580,2017-08-20,Salary,8600,D,96336
277917580,2017-08-23,Incentive,46528,D,142864
277917580,2017-08-23,Credit-bill,10399,W,132465
277917580,2017-08-26,Friend,23553,D,156018
277917580,2017-08-27,Salary,28695,D,184713
277917580,2017-09-02,Credit-bill,3414,W,181299
277917580,2017-09-13,Incentive,17843,D,199142
277917580,2017-09-16,Rent-payment,9865,W,189277
277917580,2017-09-24,Bank-transfered,28118,W,161159
277917580,2017-09-30,Credit-bill,27175,W,133984
277917580,2017-10-02,Other,35790,D,169774
277917580,2017-10-07,Credit-bill,3059,W,166715
277917580,2017-10-14,Rent-payment,40872,W,125843
277917580,2017-10-23,Other,5737,D,131580
277917580,2017-10-28,Incentive,25464,D,157044
277917580,2017-12-13,Rent-payment,10628,W,146416
277917580,2017-12-27,Friend,49502,D,195918
277917580,2017-12-29,Friend,16558,D,212476
277917580,2018-01-03,Friend,8144,D,220620
277917580,2018-01-09,Rent-payment,47063,W,173557
277917580,2018-01-14,Other,27914,D,201471
277917580,2018-01-15,Incentive,5221,D,206692
277917580,2018-01-17,Other,38566,D,245258
277917580,2018-01-30,Other,43979,D,289237
277917580,2018-01-31,Incentive,14443,D,303680
277917580,2018-02-02,Friend,11248,D,314928
277917580,2018-02-04,Other,33042,D,347970
277917580,2018-02-04,Online-Shopping,30998,W,316972
277917580,2018-02-07,Fuel,30594,W,286378
277917580,2018-02-09,Other,10211,D,296589
277917580,2018-02-16,Bank-transfered,20913,W,275676
277917580,2018-02-26,Online-Shopping,37124,W,238552
277917580,2018-02-26,Incentive,10451,D,249003
277917580,2018-03-01,Salary,4811,D,253814
277917580,2018-03-08,Fuel,34534,W,219280
277917580,2018-03-11,Bank-transfered,46402,W,172878
277917580,2018-03-14,Fuel,22069,W,150809
277917580,2018-03-23,Salary,47301,D,198110
277917580,2018-03-27,Other,13379,D,211489
277917580,2018-04-02,Friend,40742,D,252231
277917580,2018-04-08,Rent-payment,17325,W,234906
277917580,2018-04-09,Incentive,28531,D,263437
277917580,2018-04-11,Friend,29271,D,292708
277917580,2018-04-16,Online-Shopping,36899,W,255809
277917580,2018-05-02,Incentive,13834,D,269643
277917580,2018-05-09,Other,45704,D,315347
277917580,2018-05-11,Rent-payment,43383,W,271964
277917580,2018-05-12,Incentive,21463,D,293427
277917580,2018-05-20,Friend,23594,D,317021
277917580,2018-05-29,Bank-transfered,26143,W,290878
277917580,2018-06-05,Incentive,34951,D,325829
277917580,2018-06-06,Fuel,15307,W,310522
277917580,2018-06-11,Incentive,31807,D,342329
277917580,2018-06-14,Fuel,15053,W,327276
277917580,2018-06-22,Incentive,15467,D,342743
277917580,2018-06-27,Rent-payment,28493,W,314250
277917580,2018-06-29,Other,4014,D,318264
277917580,2018-07-13,Online-Shopping,17208,W,301056
277917580,2018-07-16,Rent-payment,1316,W,299740
277917580,2018-08-07,Other,17297,W,282443
277917580,2018-08-07,Bank-transfered,27752,W,254691
277917580,2018-08-12,Incentive,35859,D,290550
277917580,2018-08-21,Incentive,35637,D,326187
277917580,2018-08-27,Bank-transfered,2828,W,323359
277917580,2018-08-27,Rent-payment,38390,W,284969
277917580,2018-08-27,Friend,43483,D,328452
277917580,2018-09-09,Other,30527,D,358979
277917580,2018-09-16,Other,22746,D,381725
277917580,2018-09-16,Credit-bill,4400,W,377325
277917580,2018-09-21,Bank-transfered,4436,W,372889
277917580,2018-09-24,Online-Shopping,25769,W,347120
277917580,2018-09-28,Salary,2843,D,349963
277917580,2018-09-29,Credit-bill,33919,W,316044
277917580,2018-10-03,Other,43560,D,359604
277917580,2018-10-08,Friend,24905,D,384509
277917580,2018-10-13,Online-Shopping,7847,W,376662
277917580,2018-10-14,Friend,28047,D,404709
277917580,2018-10-19,Salary,35463,D,440172
277917580,2018-10-20,Fuel,45027,W,395145
277917580,2018-10-21,Rent-payment,11437,W,383708
277917580,2018-10-22,Online-Shopping,32563,W,351145
277917580,2018-10-27,Fuel,21032,W,330113
277917580,2018-11-01,Salary,2191,D,332304
277917580,2018-11-04,Other,48817,W,283487
277917580,2018-11-04,Other,24833,D,308320
277917580,2018-11-21,Other,7765,D,316085
277917580,2018-12-06,Online-Shopping,39801,W,276284
277917580,2018-12-07,Friend,36982,D,313266
277917580,2018-12-16,Rent-payment,26465,W,286801
277917580,2018-12-18,Other,44776,D,331577
277917580,2018-12-27,Friend,37008,D,368585
277917580,2018-12-28,Bank-transfered,14646,W,353939
277917580,2018-12-29,Other,39108,D,393047
277917580,2018-12-31,Other,47328,D,440375
277917580,2019-01-10,Bank-transfered,8480,W,431895
277917580,2019-01-24,Other,45854,W,386041
277917580,2019-01-25,Fuel,17036,W,369005
277917580,2019-02-07,Bank-transfered,49785,W,319220
277917580,2019-02-10,Salary,36421,D,355641
277917580,2019-02-10,Friend,35473,D,391114
277917580,2019-02-10,Bank-transfered,36447,W,354667
277917580,2019-02-19,Friend,25182,D,379849
277917580,2019-03-05,Incentive,5656,D,385505
277917580,2019-03-09,Incentive,7923,D,393428
277917580,2019-03-10,Friend,18860,D,412288
277917580,2019-03-14,Other,42023,D,454311
277917580,2019-03-15,Friend,44364,D,498675
277917580,2019-03-16,Rent-payment,48161,W,450514
277917580,2019-03-24,Rent-payment,47735,W,402779
277917580,2019-03-28,Friend,5267,D,408046
277917580,2019-04-03,Online-Shopping,11656,W,396390
277917580,2019-04-04,Online-Shopping,15203,W,381187
277917580,2019-04-07,Incentive,12455,D,393642
277917580,2019-04-09,Other,39527,W,354115
277917580,2019-04-20,Other,19213,D,373328
277917580,2019-04-27,Rent-payment,2457,W,370871
277917580,2019-05-03,Bank-transfered,9962,W,360909
277917580,2019-05-04,Salary,6284,D,367193
277917580,2019-05-05,Other,7467,D,374660
277917580,2019-05-10,Friend,44095,D,418755
277917580,2019-05-15,Other,4633,D,423388
277917580,2019-05-19,Friend,38213,D,461601
277917580,2019-05-23,Online-Shopping,2748,W,458853
277917580,2019-05-24,Bank-transfered,42813,W,416040
277917580,2019-05-25,Incentive,35600,D,451640
277917580,2019-05-28,Rent-payment,45231,W,406409
277917580,2019-06-01,Other,26162,D,432571
277917580,2019-06-04,Online-Shopping,46346,W,386225
277917580,2019-06-08,Friend,34114,D,420339
277917580,2019-06-08,Online-Shopping,9072,W,411267
277917580,2019-06-10,Other,4314,D,415581
277917580,2019-06-12,Other,4521,W,411060
277917580,2019-06-12,Friend,13821,D,424881
277917580,2019-06-18,Bank-transfered,46346,W,378535
277917580,2019-06-20,Incentive,48538,D,427073
277917580,2019-06-28,Salary,40687,D,467760
277917580,2019-07-03,Bank-transfered,30777,W,436983
277917580,2019-07-05,Online-Shopping,47239,W,389744
277917580,2019-07-23,Online-Shopping,35082,W,354662
277917580,2019-07-26,Incentive,27081,D,381743
277917580,2019-07-27,Salary,12263,D,394006
277917580,2019-08-17,Bank-transfered,49300,W,344706
277917580,2019-08-20,Salary,5568,D,350274
277917580,2019-08-26,Other,24944,W,325330
277917580,2019-08-30,Online-Shopping,33396,W,291934
277917580,2019-09-02,Credit-bill,8094,W,283840
277917580,2019-09-14,Credit-bill,44526,W,239314
277917580,2019-09-16,Credit-bill,47355,W,191959
277917580,2019-09-19,Rent-payment,39168,W,152791
277917580,2019-09-27,Salary,33067,D,185858
277917580,2019-10-06,Fuel,22829,W,163029
277917580,2019-10-19,Credit-bill,10662,W,152367
277917580,2019-10-24,Salary,23603,D,175970
277917580,2019-11-14,Salary,16291,D,192261
277917580,2019-11-15,Online-Shopping,45312,W,146949
277917580,2019-11-19,Other,25542,D,172491
277917580,2019-11-27,Bank-transfered,31369,W,141122
277917580,2019-11-29,Bank-transfered,5618,W,135504
277917580,2019-12-01,Incentive,21624,D,157128
277917580,2019-12-03,Salary,4987,D,162115
277917580,2019-12-24,Friend,35780,D,197895
277917580,2019-12-26,Bank-transfered,21982,W,175913
277917580,2019-12-27,Incentive,3930,D,179843
277917580,2019-12-30,Incentive,9287,D,189130
277917580,2020-01-07,Credit-bill,13891,W,175239
277917580,2020-01-09,Other,44744,W,130495
277917580,2020-01-15,Online-Shopping,1581,W,128914
277917580,2020-01-19,Fuel,48780,W,80134
277917580,2020-01-24,Friend,22692,D,102826
277917580,2020-02-06,Bank-transfered,47387,W,55439
277917580,2020-02-10,Other,19169,D,74608
277917580,2020-02-10,Online-Shopping,37757,W,36851
277917580,2020-02-20,Incentive,35662,D,72513
277917580,2020-02-20,Friend,41084,D,113597
277917580,2020-03-05,Bank-transfered,41013,W,72584
277917580,2020-03-06,Salary,28306,D,100890
277917580,2020-03-07,Rent-payment,49724,W,51166
277917580,2020-03-22,Incentive,27161,D,78327
277917580,2020-03-25,Other,19757,W,58570
277917580,2020-03-25,Incentive,20276,D,78846
277917580,2020-03-28,Salary,20103,D,98949
277917580,2020-03-29,Fuel,5593,W,93356
277917580,2020-04-02,Incentive,17223,D,110579
277917580,2020-04-02,Other,15077,D,125656
277917580,2020-04-15,Incentive,25942,D,151598
277917580,2020-04-22,Bank-transfered,23597,W,128001
277917580,2020-04-23,Friend,46186,D,174187
277917580,2020-05-01,Rent-payment,9221,W,164966
277917580,2020-05-05,Credit-bill,18400,W,146566
277917580,2020-05-05,Salary,37872,D,184438
277917580,2020-05-07,Fuel,24595,W,159843
277917580,2020-05-08,Other,22287,W,137556
277917580,2020-05-12,Incentive,39417,D,176973
277917580,2020-05-13,Friend,49139,D,226112
277917580,2020-05-22,Other,48940,W,177172
277917580,2020-05-26,Bank-transfered,49943,W,127229
277917580,2020-05-28,Friend,24137,D,151366
277917580,2020-05-29,Other,14153,W,137213
277917580,2020-06-04,Fuel,37215,W,99998
277917580,2020-06-05,Incentive,46002,D,146000
277917580,2020-06-09,Other,26967,D,172967
277917580,2020-06-10,Incentive,18086,D,191053
277917580,2020-06-13,Fuel,36748,W,154305
277917580,2020-06-16,Bank-transfered,29068,W,125237
277917580,2020-06-24,Incentive,48313,D,173550
277917580,2020-06-24,Fuel,43322,W,130228
277917580,2020-06-25,Credit-bill,20683,W,109545
277917580,2020-06-29,Incentive,29520,D,139065
277917580,2020-07-06,Salary,41439,D,180504
277917580,2020-07-08,Credit-bill,10127,W,170377
277917580,2020-07-17,Friend,34455,D,204832
277917580,2020-07-19,Rent-payment,7010,W,197822
277917580,2020-08-01,Salary,42559,D,240381
277917580,2020-08-06,Other,36935,D,277316
277917580,2020-08-12,Fuel,9066,W,268250
277917580,2020-08-17,Credit-bill,47229,W,221021
277917580,2020-08-26,Other,7953,W,213068
277917580,2020-09-09,Credit-bill,22146,W,190922
277917580,2020-09-15,Rent-payment,13397,W,177525
277917580,2020-09-20,Other,23755,D,201280
277917580,2020-10-02,Incentive,21842,D,223122
277917580,2020-10-07,Friend,20848,D,243970
277917580,2020-10-22,Salary,49346,D,293316
277917580,2020-10-31,Online-Shopping,48091,W,245225
277917580,2020-11-01,Incentive,11747,D,256972
277917580,2020-11-02,Incentive,25884,D,282856
277917580,2020-11-05,Other,20804,D,303660
277917580,2020-11-08,Bank-transfered,46855,W,256805
277917580,2020-11-10,Fuel,10034,W,246771
277917580,2020-11-12,Bank-transfered,25094,W,221677
277917580,2020-11-18,Other,9591,W,212086
277917580,2020-11-30,Friend,22460,D,234546
277917580,2020-12-02,Salary,29041,D,263587
277917580,2020-12-10,Salary,11424,D,275011
277917580,2020-12-17,Incentive,33082,D,308093
277917580,2020-12-18,Friend,17701,D,325794
277917580,2020-12-19,Friend,28671,D,354465
277917580,2020-12-28,Other,27776,D,382241
277917580,2020-12-31,Other,7476,W,374765
277917580,2021-01-03,Friend,35481,D,410246
277917580,2021-01-05,Bank-transfered,22211,W,388035
277917580,2021-01-17,Fuel,7243,W,380792
277917580,2021-01-20,Online-Shopping,1196,W,379596
277917580,2021-01-21,Bank-transfered,31829,W,347767
277917580,2021-01-23,Salary,22791,D,370558
277917580,2021-01-27,Rent-payment,12161,W,358397
277917580,2021-01-28,Bank-transfered,35944,W,322453
277917580,2021-02-10,Fuel,46867,W,275586
277917580,2021-02-14,Online-Shopping,42029,W,233557
277917580,2021-02-15,Bank-transfered,46083,W,187474
277917580,2021-02-19,Incentive,14651,D,202125
277917580,2021-02-20,Incentive,25423,D,227548
277917580,2021-02-23,Rent-payment,32042,W,195506
277917580,2021-03-24,Credit-bill,35116,W,160390
277917580,2021-03-27,Salary,16523,D,176913
277917580,2021-03-28,Friend,17528,D,194441
277917580,2021-04-06,Other,29446,W,164995
277917580,2021-04-13,Other,37898,W,127097
277917580,2021-04-16,Friend,25198,D,152295
277917580,2021-04-22,Friend,49052,D,201347
277917580,2021-04-24,Salary,6956,D,208303
277917580,2021-05-09,Fuel,41826,W,166477
277917580,2021-05-14,Incentive,47592,D,214069
277917580,2021-05-14,Bank-transfered,28244,W,185825
277917580,2021-05-20,Salary,9350,D,195175
277917580,2021-05-25,Online-Shopping,12160,W,183015
277917580,2021-05-27,Online-Shopping,20484,W,162531
277917580,2021-05-28,Friend,7469,D,170000
277917580,2021-05-31,Incentive,43211,D,213211
277917580,2021-06-10,Fuel,12067,W,201144
277917580,2021-06-12,Rent-payment,41917,W,159227
277917580,2021-06-13,Salary,24196,D,183423
277917580,2021-06-28,Other,28336,W,155087
277917580,2021-06-28,Bank-transfered,26826,W,128261
277917580,2021-07-09,Other,41676,W,86585
277917580,2021-07-10,Credit-bill,43189,W,43396
277917580,2021-07-17,Other,2564,D,45960
277917580,2021-07-27,Friend,38893,D,84853
277917580,2021-08-06,Rent-payment,13031,W,71822
277917580,2021-08-07,Rent-payment,32303,W,39519
277917580,2021-08-16,Friend,12438,D,51957
277917580,2021-09-05,Online-Shopping,12149,W,39808
277917580,2021-09-09,Rent-payment,17624,W,22184
277917580,2021-09-14,Salary,38018,D,60202
277917580,2021-10-04,Salary,40037,D,100239
277917580,2021-10-05,Incentive,37247,D,137486
277917580,2021-10-11,Incentive,8523,D,146009
277917580,2021-11-01,Other,49194,D,195203
277917580,2021-11-03,Credit-bill,8000,W,187203
277917580,2021-11-08,Salary,15553,D,202756
277917580,2021-11-18,Salary,36059,D,238815
277917580,2021-11-21,Online-Shopping,5115,W,233700
277917580,2021-11-23,Online-Shopping,45742,W,187958
277917580,2021-12-04,Friend,24720,D,212678
277917580,2021-12-08,Other,34966,D,247644
277917580,2021-12-09,Friend,42102,D,289746
277917580,2021-12-13,Incentive,7180,D,296926
277917580,2021-12-14,Bank-transfered,16407,W,280519
277917580,2021-12-21,Online-Shopping,10314,W,270205
277917580,2021-12-24,Online-Shopping,35336,W,234869
277917580,2021-12-25,Fuel,13567,W,221302
260874582,2017-01-04,Online-Shopping,24375,W,179908
260874582,2017-01-10,Bank-transfered,28273,W,151635
260874582,2017-01-10,Salary,3790,D,155425
260874582,2017-01-15,Rent-payment,6856,W,148569
260874582,2017-01-17,Incentive,1877,D,150446
260874582,2017-01-22,Salary,28637,D,179083
260874582,2017-02-06,Salary,39114,D,218197
260874582,2017-02-14,Online-Shopping,18440,W,199757
260874582,2017-02-24,Other,2419,D,202176
260874582,2017-02-28,Bank-transfered,16378,W,185798
260874582,2017-03-04,Credit-bill,17297,W,168501
260874582,2017-03-07,Fuel,14489,W,154012
260874582,2017-03-27,Credit-bill,5353,W,148659
260874582,2017-04-11,Incentive,39901,D,188560
260874582,2017-04-19,Other,35250,D,223810
260874582,2017-04-21,Friend,18622,D,242432
260874582,2017-04-27,Online-Shopping,24548,W,217884
260874582,2017-05-01,Other,28360,D,246244
260874582,2017-05-02,Incentive,8122,D,254366
260874582,2017-05-05,Bank-transfered,46549,W,207817
260874582,2017-05-06,Credit-bill,10559,W,197258
260874582,2017-05-07,Other,41524,D,238782
260874582,2017-05-10,Incentive,22844,D,261626
260874582,2017-05-12,Fuel,22268,W,239358
260874582,2017-05-15,Incentive,39669,D,279027
260874582,2017-05-28,Other,22520,D,301547
260874582,2017-06-03,Online-Shopping,1093,W,300454
260874582,2017-06-07,Other,16389,W,284065
260874582,2017-06-19,Other,34011,W,250054
260874582,2017-06-20,Incentive,38936,D,288990
260874582,2017-06-24,Friend,16183,D,305173
260874582,2017-07-10,Incentive,6978,D,312151
260874582,2017-07-13,Salary,14479,D,326630
260874582,2017-07-14,Other,44592,D,371222
260874582,2017-07-16,Fuel,40262,W,330960
260874582,2017-07-26,Credit-bill,45529,W,285431
260874582,2017-07-29,Friend,6508,D,291939
260874582,2017-08-01,Salary,25677,D,317616
260874582,2017-08-09,Friend,28924,D,346540
260874582,2017-08-09,Salary,4500,D,351040
260874582,2017-08-21,Rent-payment,3981,W,347059
260874582,2017-08-22,Other,35155,W,311904
260874582,2017-08-26,Other,20158,W,291746
260874582,2017-09-08,Incentive,48641,D,340387
260874582,2017-09-12,Other,45967,D,386354
260874582,2017-09-13,Fuel,29406,W,356948
260874582,2017-10-03,Friend,33306,D,390254
260874582,2017-10-04,Credit-bill,44323,W,345931
260874582,2017-10-12,Salary,13078,D,359009
260874582,2017-10-15,Salary,39656,D,398665
260874582,2017-10-16,Salary,17145,D,415810
260874582,2017-10-17,Friend,26184,D,441994
260874582,2017-10-23,Other,46221,W,395773
260874582,2017-10-29,Online-Shopping,32815,W,362958
260874582,2017-10-30,Rent-payment,30256,W,332702
260874582,2017-12-03,Credit-bill,8159,W,324543
260874582,2017-12-06,Salary,42214,D,366757
260874582,2017-12-16,Other,47349,D,414106
260874582,2017-12-17,Friend,8740,D,422846
260874582,2017-12-22,Incentive,5469,D,428315
260874582,2017-12-30,Salary,27688,D,456003
260874582,2018-01-06,Incentive,39353,D,495356
260874582,2018-01-07,Fuel,30732,W,464624
260874582,2018-01-09,Other,48549,D,513173
260874582,2018-01-15,Friend,36937,D,550110
260874582,2018-01-22,Other,19003,W,531107
260874582,2018-02-16,Bank-transfered,3925,W,527182
260874582,2018-02-18,Salary,23535,D,550717
260874582,2018-02-18,Online-Shopping,42567,W,508150
260874582,2018-02-21,Other,35054,D,543204
260874582,2018-02-23,Incentive,25182,D,568386
260874582,2018-03-02,Fuel,31325,W,537061
260874582,2018-03-04,Credit-bill,20577,W,516484
260874582,2018-03-09,Other,38014,D,554498
260874582,2018-03-17,Incentive,44501,D,598999
260874582,2018-03-18,Bank-transfered,34381,W,564618
260874582,2018-03-19,Friend,44875,D,609493
260874582,2018-03-21,Other,17459,W,592034
260874582,2018-04-03,Bank-transfered,8996,W,583038
260874582,2018-04-08,Rent-payment,25991,W,557047
260874582,2018-04-11,Salary,1103,D,558150
260874582,2018-05-01,Other,24777,W,533373
260874582,2018-05-05,Credit-bill,16277,W,517096
260874582,2018-05-10,Friend,35631,D,552727
260874582,2018-05-14,Other,47792,D,600519
260874582,2018-05-16,Other,3417,D,603936
260874582,2018-05-20,Rent-payment,3340,W,600596
260874582,2018-05-22,Credit-bill,2618,W,597978
260874582,2018-05-28,Online-Shopping,27826,W,570152
260874582,2018-05-28,Friend,14141,D,584293
260874582,2018-06-01,Other,48755,W,535538
260874582,2018-06-09,Other,42819,D,578357
260874582,2018-06-11,Online-Shopping,44616,W,533741
260874582,2018-06-13,Fuel,17109,W,516632
260874582,2018-06-17,Incentive,27719,D,544351
260874582,2018-06-25,Friend,21922,D,566273
260874582,2018-07-12,Salary,14051,D,580324
260874582,2018-07-14,Friend,2025,D,582349
260874582,2018-07-14,Online-Shopping,8776,W,573573
260874582,2018-07-19,Fuel,33388,W,540185
260874582,2018-07-21,Incentive,35108,D,575293
260874582,2018-07-29,Incentive,47695,D,622988
260874582,2018-07-30,Bank-transfered,43095,W,579893
260874582,2018-07-31,Fuel,31300,W,548593
260874582,2018-08-01,Friend,11002,D,559595
260874582,2018-08-08,Bank-transfered,32590,W,527005
260874582,2018-08-17,Other,42223,W,484782
260874582,2018-08-24,Rent-payment,11117,W,473665
260874582,2018-08-30,Other,12872,W,460793
260874582,2018-09-02,Other,37946,W,422847
260874582,2018-09-05,Credit-bill,20244,W,402603
260874582,2018-09-13,Other,46012,W,356591
260874582,2018-09-16,Salary,4196,D,360787
260874582,2018-09-16,Rent-payment,8642,W,352145
260874582,2018-09-24,Friend,7890,D,360035
260874582,2018-10-03,Rent-payment,47933,W,312102
260874582,2018-10-06,Friend,26265,D,338367
260874582,2018-10-07,Rent-payment,1536,W,336831
260874582,2018-10-12,Online-Shopping,5931,W,330900
260874582,2018-10-18,Other,4192,D,335092
260874582,2018-10-22,Salary,8492,D,343584
260874582,2018-10-22,Other,33076,D,376660
260874582,2018-11-04,Other,12406,D,389066
260874582,2018-11-11,Other,34930,W,354136
260874582,2018-11-15,Credit-bill,24284,W,329852
260874582,2018-11-22,Credit-bill,29051,W,300801
260874582,2018-11-22,Friend,24175,D,324976
260874582,2018-12-11,Friend,29051,D,354027
260874582,2019-01-02,Incentive,44869,D,398896
260874582,2019-01-11,Fuel,25898,W,372998
260874582,2019-01-13,Other,42680,W,330318
260874582,2019-01-15,Fuel,15389,W,314929
260874582,2019-01-20,Rent-payment,42184,W,272745
260874582,2019-01-26,Rent-payment,37863,W,234882
260874582,2019-02-08,Rent-payment,13958,W,220924
260874582,2019-02-14,Bank-transfered,43931,W,176993
260874582,2019-02-17,Fuel,30480,W,146513
260874582,2019-02-18,Salary,13610,D,160123
260874582,2019-02-25,Other,16055,W,144068
260874582,2019-03-01,Salary,2504,D,146572
260874582,2019-03-11,Salary,18577,D,165149
260874582,2019-03-22,Rent-payment,10011,W,155138
260874582,2019-04-01,Salary,20272,D,175410
260874582,2019-04-02,Fuel,8856,W,166554
260874582,2019-04-13,Incentive,40671,D,207225
260874582,2019-04-17,Salary,21320,D,228545
260874582,2019-04-21,Incentive,12782,D,241327
260874582,2019-04-30,Incentive,11736,D,253063
260874582,2019-05-06,Salary,46259,D,299322
260874582,2019-05-08,Online-Shopping,1162,W,298160
260874582,2019-05-13,Other,10948,D,309108
260874582,2019-05-14,Online-Shopping,37902,W,271206
260874582,2019-05-20,Online-Shopping,31077,W,240129
260874582,2019-05-24,Other,39758,W,200371
260874582,2019-05-26,Other,19166,W,181205
260874582,2019-06-05,Other,17660,D,198865
260874582,2019-06-15,Friend,14178,D,213043
260874582,2019-07-21,Other,41892,D,254935
260874582,2019-07-21,Friend,35773,D,290708
260874582,2019-08-07,Salary,42894,D,333602
260874582,2019-09-07,Other,34516,D,368118
260874582,2019-09-23,Incentive,46697,D,414815
260874582,2019-09-28,Bank-transfered,34099,W,380716
260874582,2019-09-29,Credit-bill,15835,W,364881
260874582,2019-10-07,Credit-bill,14640,W,350241
260874582,2019-10-08,Salary,38496,D,388737
260874582,2019-10-10,Friend,40183,D,428920
260874582,2019-10-15,Friend,24577,D,453497
260874582,2019-10-16,Salary,14036,D,467533
260874582,2019-10-24,Fuel,42002,W,425531
260874582,2019-10-26,Friend,31924,D,457455
260874582,2019-11-09,Rent-payment,31088,W,426367
260874582,2019-11-13,Friend,33161,D,459528
260874582,2019-11-18,Rent-payment,26893,W,432635
260874582,2019-11-18,Online-Shopping,31691,W,400944
260874582,2019-11-23,Other,1774,D,402718
260874582,2019-11-26,Friend,42955,D,445673
260874582,2019-12-01,Other,3690,D,449363
260874582,2019-12-05,Friend,5672,D,455035
260874582,2019-12-06,Other,46075,D,501110
260874582,2019-12-06,Online-Shopping,24651,W,476459
260874582,2019-12-08,Salary,37643,D,514102
260874582,2019-12-13,Incentive,9326,D,523428
260874582,2019-12-22,Online-Shopping,29380,W,494048
260874582,2019-12-27,Rent-payment,7118,W,486930
260874582,2019-12-31,Other,9636,W,477294
260874582,2020-01-10,Salary,49499,D,526793
260874582,2020-01-23,Online-Shopping,14843,W,511950
260874582,2020-01-26,Salary,14039,D,525989
260874582,2020-01-27,Friend,41588,D,567577
260874582,2020-02-05,Fuel,3056,W,564521
260874582,2020-02-07,Rent-payment,12446,W,552075
260874582,2020-02-10,Credit-bill,7404,W,544671
260874582,2020-02-12,Fuel,3037,W,541634
260874582,2020-02-14,Friend,39552,D,581186
260874582,2020-02-16,Other,26340,D,607526
260874582,2020-02-18,Other,19336,W,588190
260874582,2020-02-25,Friend,9837,D,598027
260874582,2020-03-06,Other,40298,W,557729
260874582,2020-03-14,Fuel,16514,W,541215
260874582,2020-03-20,Online-Shopping,9035,W,532180
260874582,2020-03-30,Online-Shopping,43810,W,488370
260874582,2020-04-03,Bank-transfered,12989,W,475381
260874582,2020-04-09,Fuel,32700,W,442681
260874582,2020-04-09,Incentive,46864,D,489545
260874582,2020-04-14,Salary,34205,D,523750
260874582,2020-04-24,Friend,47044,D,570794
260874582,2020-05-04,Friend,11961,D,582755
260874582,2020-05-06,Bank-transfered,5091,W,577664
260874582,2020-05-24,Friend,32100,D,609764
260874582,2020-05-27,Other,40404,D,650168
260874582,2020-05-30,Online-Shopping,7563,W,642605
260874582,2020-06-03,Credit-bill,12055,W,630550
260874582,2020-06-13,Other,34497,D,665047
260874582,2020-06-20,Other,48139,W,616908
260874582,2020-06-23,Incentive,48996,D,665904
260874582,2020-07-11,Other,43785,D,709689
260874582,2020-07-11,Credit-bill,15278,W,694411
260874582,2020-07-17,Other,6943,W,687468
260874582,2020-07-20,Fuel,6530,W,680938
260874582,2020-07-23,Salary,46160,D,727098
260874582,2020-07-30,Online-Shopping,11603,W,715495
260874582,2020-08-04,Salary,35527,D,751022
260874582,2020-08-13,Incentive,22233,D,773255
260874582,2020-08-17,Bank-transfered,49876,W,723379
260874582,2020-08-24,Incentive,4743,D,728122
260874582,2020-08-28,Incentive,19132,D,747254
260874582,2020-09-11,Other,23512,W,723742
260874582,2020-10-01,Fuel,24935,W,698807
260874582,2020-10-05,Bank-transfered,48359,W,650448
260874582,2020-10-05,Incentive,19695,D,670143
260874582,2020-10-08,Friend,10105,D,680248
260874582,2020-10-15,Salary,31152,D,711400
260874582,2020-10-16,Salary,29199,D,740599
260874582,2020-10-17,Rent-payment,32520,W,708079
260874582,2020-10-20,Friend,16201,D,724280
260874582,2020-10-26,Credit-bill,17677,W,706603
260874582,2020-10-29,Other,35391,D,741994
260874582,2020-11-03,Salary,17372,D,759366
260874582,2020-11-06,Bank-transfered,42220,W,717146
260874582,2020-11-10,Rent-payment,11561,W,705585
260874582,2020-11-17,Other,33176,D,738761
260874582,2020-11-28,Rent-payment,31348,W,707413
260874582,2020-12-09,Other,31612,W,675801
260874582,2020-12-17,Friend,40194,D,715995
260874582,2020-12-19,Friend,7125,D,723120
260874582,2020-12-22,Fuel,22884,W,700236
260874582,2020-12-23,Salary,34660,D,734896
260874582,2020-12-24,Other,45326,D,780222
260874582,2020-12-25,Other,23131,D,803353
260874582,2021-01-06,Bank-transfered,30320,W,773033
260874582,2021-01-10,Online-Shopping,15803,W,757230
260874582,2021-01-17,Other,21596,D,778826
260874582,2021-01-21,Fuel,47994,W,730832
260874582,2021-02-01,Friend,29935,D,760767
260874582,2021-02-19,Fuel,23801,W,736966
260874582,2021-02-21,Salary,5688,D,742654
260874582,2021-03-08,Fuel,36996,W,705658
260874582,2021-03-26,Bank-transfered,5164,W,700494
260874582,2021-04-05,Online-Shopping,36922,W,663572
260874582,2021-04-17,Online-Shopping,45919,W,617653
260874582,2021-04-21,Friend,18762,D,636415
260874582,2021-04-28,Credit-bill,2946,W,633469
260874582,2021-04-28,Incentive,40785,D,674254
260874582,2021-04-29,Bank-transfered,7663,W,666591
260874582,2021-05-04,Incentive,28597,D,695188
260874582,2021-05-07,Friend,9597,D,704785
260874582,2021-05-09,Other,35520,D,740305
260874582,2021-05-21,Salary,38949,D,779254
260874582,2021-05-26,Friend,41126,D,820380
260874582,2021-05-31,Online-Shopping,47272,W,773108
260874582,2021-05-31,Rent-payment,40916,W,732192
260874582,2021-06-05,Credit-bill,17377,W,714815
260874582,2021-06-14,Other,26144,W,688671
260874582,2021-06-14,Incentive,14249,D,702920
260874582,2021-06-14,Salary,46259,D,749179
260874582,2021-06-17,Friend,3017,D,752196
260874582,2021-06-25,Fuel,18946,W,733250
260874582,2021-06-30,Credit-bill,46503,W,686747
260874582,2021-07-05,Other,6674,D,693421
260874582,2021-07-20,Other,7938,W,685483
260874582,2021-07-22,Other,32124,D,717607
260874582,2021-07-26,Other,33222,D,750829
260874582,2021-08-25,Salary,24121,D,774950
260874582,2021-09-01,Other,48373,W,726577
260874582,2021-09-05,Fuel,14199,W,712378
260874582,2021-09-08,Salary,4732,D,717110
260874582,2021-09-09,Other,40609,W,676501
260874582,2021-09-09,Salary,35111,D,711612
260874582,2021-09-09,Other,12019,W,699593
260874582,2021-09-10,Salary,26061,D,725654
260874582,2021-09-20,Bank-transfered,20932,W,704722
260874582,2021-09-28,Friend,12028,D,716750
260874582,2021-10-07,Salary,36643,D,753393
260874582,2021-10-08,Friend,37191,D,790584
260874582,2021-10-11,Other,49526,D,840110
260874582,2021-10-13,Other,14810,W,825300
260874582,2021-10-21,Incentive,44097,D,869397
260874582,2021-10-30,Online-Shopping,12874,W,856523
260874582,2021-11-04,Incentive,46719,D,903242
260874582,2021-11-05,Other,5214,W,898028
260874582,2021-11-07,Other,49832,W,848196
260874582,2021-11-10,Friend,49200,D,897396
260874582,2021-11-14,Rent-payment,42559,W,854837
260874582,2021-11-15,Rent-payment,48365,W,806472
260874582,2021-11-16,Other,46907,W,759565
260874582,2021-11-20,Fuel,20552,W,739013
260874582,2021-11-25,Salary,8492,D,747505
260874582,2021-11-27,Incentive,47703,D,795208
260874582,2021-12-08,Fuel,28696,W,766512
260874582,2021-12-15,Bank-transfered,26840,W,739672
260874582,2021-12-21,Salary,9418,D,749090
260874582,2021-12-31,Incentive,34085,D,783175
411482222,2017-01-05,Rent-payment,14869,W,734076
411482222,2017-01-05,Friend,33826,D,767902
411482222,2017-01-08,Other,16287,W,751615
411482222,2017-01-31,Rent-payment,40490,W,711125
411482222,2017-02-03,Friend,1659,D,712784
411482222,2017-02-05,Credit-bill,45592,W,667192
411482222,2017-02-18,Online-Shopping,40303,W,626889
411482222,2017-02-19,Salary,11342,D,638231
411482222,2017-02-27,Fuel,13030,W,625201
411482222,2017-03-05,Incentive,23136,D,648337
411482222,2017-03-11,Rent-payment,16066,W,632271
411482222,2017-03-22,Fuel,2970,W,629301
411482222,2017-03-24,Online-Shopping,37671,W,591630
411482222,2017-04-10,Other,49769,D,641399
411482222,2017-04-12,Other,30844,W,610555
411482222,2017-04-15,Other,16711,D,627266
411482222,2017-04-27,Other,21210,D,648476
411482222,2017-04-28,Online-Shopping,43639,W,604837
411482222,2017-05-12,Other,16221,D,621058
411482222,2017-06-09,Online-Shopping,18811,W,602247
411482222,2017-06-09,Incentive,28588,D,630835
411482222,2017-06-10,Other,29048,W,601787
411482222,2017-06-29,Friend,1211,D,602998
411482222,2017-07-12,Salary,32400,D,635398
411482222,2017-07-22,Salary,21525,D,656923
411482222,2017-07-28,Incentive,5656,D,662579
411482222,2017-07-30,Other,42805,D,705384
411482222,2017-08-01,Salary,46779,D,752163
411482222,2017-08-11,Other,36441,D,788604
411482222,2017-08-13,Credit-bill,12428,W,776176
411482222,2017-08-17,Salary,19086,D,795262
411482222,2017-08-19,Fuel,9927,W,785335
411482222,2017-08-21,Friend,3349,D,788684
411482222,2017-09-04,Bank-transfered,10791,W,777893
411482222,2017-09-05,Bank-transfered,27611,W,750282
411482222,2017-09-06,Credit-bill,39975,W,710307
411482222,2017-09-11,Incentive,46662,D,756969
411482222,2017-09-19,Incentive,12790,D,769759
411482222,2017-10-01,Friend,15526,D,785285
411482222,2017-10-02,Incentive,11574,D,796859
411482222,2017-10-05,Credit-bill,2565,W,794294
411482222,2017-10-12,Friend,45123,D,839417
411482222,2017-10-15,Other,37913,D,877330
411482222,2017-10-23,Friend,35299,D,912629
411482222,2017-11-12,Rent-payment,14291,W,898338
411482222,2017-11-12,Online-Shopping,13279,W,885059
411482222,2017-11-15,Other,25350,W,859709
411482222,2017-12-07,Salary,7671,D,867380
411482222,2017-12-11,Online-Shopping,27335,W,840045
411482222,2017-12-13,Other,8871,D,848916
411482222,2017-12-23,Rent-payment,26031,W,822885
411482222,2018-01-01,Other,7757,D,830642
411482222,2018-01-03,Online-Shopping,39219,W,791423
411482222,2018-01-07,Online-Shopping,1823,W,789600
411482222,2018-01-15,Credit-bill,41119,W,748481
411482222,2018-01-18,Credit-bill,30655,W,717826
411482222,2018-01-25,Bank-transfered,37809,W,680017
411482222,2018-01-28,Incentive,39347,D,719364
411482222,2018-02-03,Fuel,13431,W,705933
411482222,2018-02-05,Other,38246,D,744179
411482222,2018-02-07,Other,15789,W,728390
411482222,2018-02-08,Incentive,7352,D,735742
411482222,2018-02-12,Fuel,2811,W,732931
411482222,2018-02-18,Other,28417,D,761348
411482222,2018-02-23,Bank-transfered,13538,W,747810
411482222,2018-03-02,Bank-transfered,20094,W,727716
411482222,2018-03-04,Other,47717,D,775433
411482222,2018-03-09,Incentive,12129,D,787562
411482222,2018-03-09,Friend,33915,D,821477
411482222,2018-03-15,Salary,39494,D,860971
411482222,2018-03-24,Other,20976,D,881947
411482222,2018-04-07,Salary,31772,D,913719
411482222,2018-04-19,Friend,38424,D,952143
411482222,2018-04-27,Fuel,3089,W,949054
411482222,2018-04-29,Salary,2817,D,951871
411482222,2018-04-29,Incentive,42645,D,994516
411482222,2018-05-06,Other,11798,D,1006314
411482222,2018-05-09,Friend,29714,D,1036028
411482222,2018-05-11,Other,21944,D,1057972
411482222,2018-05-30,Incentive,27962,D,1085934
411482222,2018-05-30,Bank-transfered,21185,W,1064749
411482222,2018-05-31,Other,18245,D,1082994
411482222,2018-05-31,Salary,31560,D,1114554
411482222,2018-06-15,Credit-bill,11195,W,1103359
411482222,2018-06-25,Online-Shopping,4740,W,1098619
411482222,2018-07-10,Incentive,46812,D,1145431
411482222,2018-07-10,Rent-payment,28751,W,1116680
411482222,2018-07-15,Other,22703,W,1093977
411482222,2018-07-21,Fuel,42796,W,1051181
411482222,2018-07-22,Fuel,43595,W,1007586
411482222,2018-07-29,Incentive,24595,D,1032181
411482222,2018-08-04,Other,34475,W,997706
411482222,2018-08-20,Other,10278,D,1007984
411482222,2018-08-29,Other,3626,D,1011610
411482222,2018-08-31,Other,41403,W,970207
411482222,2018-09-02,Credit-bill,45195,W,925012
411482222,2018-09-08,Bank-transfered,25464,W,899548
411482222,2018-09-12,Fuel,41306,W,858242
411482222,2018-09-30,Other,45974,D,904216
411482222,2018-10-07,Fuel,18858,W,885358
411482222,2018-10-08,Friend,5492,D,890850
411482222,2018-10-14,Bank-transfered,39849,W,851001
411482222,2018-10-24,Salary,2401,D,853402
411482222,2018-10-26,Bank-transfered,10539,W,842863
411482222,2018-11-01,Other,4260,D,847123
411482222,2018-11-06,Salary,21044,D,868167
411482222,2018-11-09,Other,35307,W,832860
411482222,2018-11-10,Other,13376,D,846236
411482222,2018-11-17,Fuel,20516,W,825720
411482222,2018-11-19,Rent-payment,12166,W,813554
411482222,2018-11-20,Bank-transfered,11284,W,802270
411482222,2018-11-24,Bank-transfered,18090,W,784180
411482222,2018-11-26,Friend,22903,D,807083
411482222,2018-11-30,Friend,14460,D,821543
411482222,2018-12-03,Incentive,33886,D,855429
411482222,2018-12-06,Rent-payment,38349,W,817080
411482222,2018-12-14,Other,37967,D,855047
411482222,2018-12-16,Incentive,1566,D,856613
411482222,2018-12-27,Friend,15888,D,872501
411482222,2018-12-27,Fuel,12343,W,860158
411482222,2019-01-13,Incentive,20391,D,880549
411482222,2019-01-14,Incentive,38514,D,919063
411482222,2019-01-20,Salary,32408,D,951471
411482222,2019-02-01,Other,38598,W,912873
411482222,2019-02-02,Fuel,40333,W,872540
411482222,2019-02-06,Online-Shopping,9386,W,863154
411482222,2019-02-19,Friend,47180,D,910334
411482222,2019-02-27,Other,5329,D,915663
411482222,2019-02-28,Fuel,7717,W,907946
411482222,2019-03-10,Other,24949,D,932895
411482222,2019-03-16,Friend,10146,D,943041
411482222,2019-03-23,Other,2114,W,940927
411482222,2019-03-31,Friend,19263,D,960190
411482222,2019-04-02,Friend,15559,D,975749
411482222,2019-04-13,Fuel,28751,W,946998
411482222,2019-04-28,Credit-bill,22220,W,924778
411482222,2019-04-29,Other,8901,W,915877
411482222,2019-05-04,Credit-bill,23257,W,892620
411482222,2019-05-05,Rent-payment,3545,W,889075
411482222,2019-05-05,Other,28657,D,917732
411482222,2019-05-08,Fuel,29579,W,888153
411482222,2019-05-13,Other,33830,W,854323
411482222,2019-05-16,Friend,6880,D,861203
411482222,2019-05-17,Credit-bill,46503,W,814700
411482222,2019-05-24,Friend,21422,D,836122
411482222,2019-06-08,Other,21136,W,814986
411482222,2019-06-12,Other,49149,D,864135
411482222,2019-06-23,Salary,13203,D,877338
411482222,2019-07-11,Other,12769,D,890107
411482222,2019-07-12,Bank-transfered,43068,W,847039
411482222,2019-07-22,Other,14899,D,861938
411482222,2019-07-27,Incentive,22710,D,884648
411482222,2019-07-28,Other,31707,W,852941
411482222,2019-08-08,Bank-transfered,41361,W,811580
411482222,2019-08-11,Incentive,43332,D,854912
411482222,2019-08-24,Fuel,28869,W,826043
411482222,2019-09-01,Incentive,10856,D,836899
411482222,2019-09-11,Rent-payment,19482,W,817417
411482222,2019-09-28,Incentive,44524,D,861941
411482222,2019-09-30,Incentive,28878,D,890819
411482222,2019-10-25,Other,40065,D,930884
411482222,2019-10-31,Friend,34131,D,965015
411482222,2019-11-09,Other,37055,W,927960
411482222,2019-11-13,Incentive,20881,D,948841
411482222,2019-11-25,Credit-bill,14865,W,933976
411482222,2019-11-26,Other,6930,D,940906
411482222,2019-12-03,Salary,36803,D,977709
411482222,2019-12-11,Rent-payment,15957,W,961752
411482222,2019-12-18,Salary,18696,D,980448
411482222,2019-12-18,Bank-transfered,10774,W,969674
411482222,2020-01-02,Rent-payment,26978,W,942696
411482222,2020-01-16,Credit-bill,12674,W,930022
411482222,2020-01-17,Credit-bill,33933,W,896089
411482222,2020-01-23,Salary,32869,D,928958
411482222,2020-01-29,Salary,30154,D,959112
411482222,2020-01-30,Online-Shopping,43482,W,915630
411482222,2020-02-07,Salary,23146,D,938776
411482222,2020-02-15,Salary,9973,D,948749
411482222,2020-02-16,Other,8908,W,939841
411482222,2020-02-17,Bank-transfered,14858,W,924983
411482222,2020-02-19,Salary,28952,D,953935
411482222,2020-02-21,Other,26675,D,980610
411482222,2020-02-25,Other,32677,D,1013287
411482222,2020-03-05,Rent-payment,36867,W,976420
411482222,2020-03-13,Other,33556,W,942864
411482222,2020-03-14,Rent-payment,30897,W,911967
411482222,2020-03-29,Friend,31287,D,943254
411482222,2020-04-25,Bank-transfered,38306,W,904948
411482222,2020-05-01,Credit-bill,8222,W,896726
411482222,2020-05-12,Online-Shopping,17028,W,879698
411482222,2020-05-13,Salary,43053,D,922751
411482222,2020-05-21,Salary,2688,D,925439
411482222,2020-05-24,Online-Shopping,39532,W,885907
411482222,2020-05-27,Incentive,9072,D,894979
411482222,2020-06-08,Other,23598,D,918577
411482222,2020-06-11,Incentive,8459,D,927036
411482222,2020-06-26,Credit-bill,40735,W,886301
411482222,2020-07-10,Incentive,14782,D,901083
411482222,2020-07-11,Other,35297,D,936380
411482222,2020-07-20,Incentive,41918,D,978298
411482222,2020-07-24,Credit-bill,10553,W,967745
411482222,2020-07-24,Bank-transfered,13998,W,953747
411482222,2020-07-28,Fuel,16240,W,937507
411482222,2020-08-04,Salary,30263,D,967770
411482222,2020-08-07,Rent-payment,35563,W,932207
411482222,2020-08-12,Salary,13304,D,945511
411482222,2020-08-18,Friend,13931,D,959442
411482222,2020-08-23,Credit-bill,24689,W,934753
411482222,2020-08-24,Salary,38456,D,973209
411482222,2020-08-24,Bank-transfered,14626,W,958583
411482222,2020-09-10,Credit-bill,13932,W,944651
411482222,2020-09-13,Fuel,4007,W,940644
411482222,2020-09-15,Friend,5707,D,946351
411482222,2020-09-16,Salary,23155,D,969506
411482222,2020-09-23,Other,29737,D,999243
411482222,2020-09-28,Bank-transfered,3970,W,995273
411482222,2020-10-03,Rent-payment,43189,W,952084
411482222,2020-10-07,Other,44887,W,907197
411482222,2020-10-07,Rent-payment,27653,W,879544
411482222,2020-10-16,Salary,14855,D,894399
411482222,2020-10-19,Online-Shopping,45656,W,848743
411482222,2020-10-24,Bank-transfered,15770,W,832973
411482222,2020-11-06,Incentive,49149,D,882122
411482222,2020-11-14,Friend,41522,D,923644
411482222,2020-11-15,Fuel,5144,W,918500
411482222,2020-11-27,Other,29240,D,947740
411482222,2020-12-03,Bank-transfered,33266,W,914474
411482222,2020-12-03,Other,48207,D,962681
411482222,2020-12-22,Rent-payment,41676,W,921005
411482222,2020-12-28,Salary,8878,D,929883
411482222,2021-01-01,Bank-transfered,12644,W,917239
411482222,2021-01-04,Incentive,33384,D,950623
411482222,2021-01-10,Rent-payment,19038,W,931585
411482222,2021-01-10,Salary,29369,D,960954
411482222,2021-01-15,Fuel,9076,W,951878
411482222,2021-01-16,Friend,41095,D,992973
411482222,2021-01-21,Salary,28099,D,1021072
411482222,2021-02-01,Other,45641,D,1066713
411482222,2021-02-01,Rent-payment,33842,W,1032871
411482222,2021-02-02,Friend,34417,D,1067288
411482222,2021-02-06,Incentive,27747,D,1095035
411482222,2021-02-07,Fuel,40754,W,1054281
411482222,2021-02-07,Salary,20292,D,1074573
411482222,2021-02-13,Incentive,23188,D,1097761
411482222,2021-02-17,Incentive,35868,D,1133629
411482222,2021-03-02,Credit-bill,33563,W,1100066
411482222,2021-03-12,Salary,19625,D,1119691
411482222,2021-03-21,Online-Shopping,2094,W,1117597
411482222,2021-03-26,Credit-bill,27060,W,1090537
411482222,2021-03-28,Incentive,46179,D,1136716
411482222,2021-03-29,Rent-payment,23872,W,1112844
411482222,2021-04-21,Online-Shopping,35817,W,1077027
411482222,2021-04-24,Incentive,49378,D,1126405
411482222,2021-05-11,Other,2803,W,1123602
411482222,2021-05-12,Salary,37286,D,1160888
411482222,2021-05-17,Friend,7775,D,1168663
411482222,2021-05-20,Salary,15211,D,1183874
411482222,2021-05-23,Friend,23906,D,1207780
411482222,2021-06-03,Friend,49045,D,1256825
411482222,2021-06-15,Fuel,16152,W,1240673
411482222,2021-06-15,Bank-transfered,6015,W,1234658
411482222,2021-06-19,Fuel,23779,W,1210879
411482222,2021-06-24,Other,18506,W,1192373
411482222,2021-07-05,Other,9526,W,1182847
411482222,2021-07-08,Other,5258,W,1177589
411482222,2021-07-11,Incentive,18941,D,1196530
411482222,2021-07-12,Other,18894,W,1177636
411482222,2021-07-13,Online-Shopping,43018,W,1134618
411482222,2021-07-19,Other,11532,D,1146150
411482222,2021-07-22,Friend,5471,D,1151621
411482222,2021-07-24,Online-Shopping,18861,W,1132760
411482222,2021-07-28,Friend,43412,D,1176172
411482222,2021-08-06,Rent-payment,37174,W,1138998
411482222,2021-08-13,Salary,14866,D,1153864
411482222,2021-08-17,Online-Shopping,14202,W,1139662
411482222,2021-08-18,Credit-bill,2796,W,1136866
411482222,2021-08-20,Salary,24172,D,1161038
411482222,2021-08-23,Salary,48866,D,1209904
411482222,2021-09-06,Incentive,5022,D,1214926
411482222,2021-09-07,Other,22291,D,1237217
411482222,2021-09-12,Rent-payment,31038,W,1206179
411482222,2021-09-13,Friend,5290,D,1211469
411482222,2021-09-15,Other,20409,D,1231878
411482222,2021-09-18,Fuel,31328,W,1200550
411482222,2021-09-20,Rent-payment,45334,W,1155216
411482222,2021-09-22,Other,47296,W,1107920
411482222,2021-09-23,Credit-bill,45462,W,1062458
411482222,2021-10-06,Incentive,32974,D,1095432
411482222,2021-10-14,Bank-transfered,47888,W,1047544
411482222,2021-10-15,Bank-transfered,11011,W,1036533
411482222,2021-10-17,Friend,9192,D,1045725
411482222,2021-10-19,Rent-payment,13144,W,1032581
411482222,2021-10-21,Friend,36048,D,1068629
411482222,2021-10-29,Credit-bill,38239,W,1030390
411482222,2021-11-05,Rent-payment,40748,W,989642
411482222,2021-11-08,Rent-payment,19088,W,970554
411482222,2021-11-09,Other,2074,D,972628
411482222,2021-11-24,Friend,14898,D,987526
411482222,2021-12-09,Salary,6444,D,993970
411482222,2021-12-12,Rent-payment,41831,W,952139
411482222,2021-12-20,Fuel,39539,W,912600
411482222,2021-12-22,Online-Shopping,41387,W,871213
411482222,2021-12-24,Other,16228,W,854985
411482222,2021-12-25,Friend,31943,D,886928
488540177,2017-01-02,Friend,26831,D,337971
488540177,2017-01-22,Other,5977,W,331994
488540177,2017-01-30,Friend,47546,D,379540
488540177,2017-02-19,Credit-bill,33800,W,345740
488540177,2017-02-22,Online-Shopping,42507,W,303233
488540177,2017-03-03,Credit-bill,3609,W,299624
488540177,2017-03-09,Fuel,17650,W,281974
488540177,2017-03-10,Salary,20055,D,302029
488540177,2017-04-02,Other,5598,W,296431
488540177,2017-04-02,Other,30394,D,326825
488540177,2017-04-28,Incentive,18055,D,344880
488540177,2017-05-07,Other,11676,W,333204
488540177,2017-05-09,Rent-payment,14635,W,318569
488540177,2017-06-01,Online-Shopping,30376,W,288193
488540177,2017-06-03,Credit-bill,31808,W,256385
488540177,2017-06-05,Other,4362,D,260747
488540177,2017-06-14,Bank-transfered,17368,W,243379
488540177,2017-06-19,Credit-bill,27864,W,215515
488540177,2017-06-24,Fuel,19804,W,195711
488540177,2017-06-28,Bank-transfered,1103,W,194608
488540177,2017-07-06,Other,34769,D,229377
488540177,2017-08-02,Incentive,29397,D,258774
488540177,2017-08-03,Rent-payment,49409,W,209365
488540177,2017-08-05,Fuel,40802,W,168563
488540177,2017-08-24,Other,17093,W,151470
488540177,2017-09-04,Other,22120,D,173590
488540177,2017-09-07,Rent-payment,8432,W,165158
488540177,2017-09-10,Rent-payment,32323,W,132835
488540177,2017-09-11,Friend,9870,D,142705
488540177,2017-09-13,Online-Shopping,36179,W,106526
488540177,2017-09-14,Incentive,36065,D,142591
488540177,2017-09-19,Salary,39056,D,181647
488540177,2017-09-28,Incentive,33236,D,214883
488540177,2017-10-08,Other,9215,W,205668
488540177,2017-10-14,Salary,38787,D,244455
488540177,2017-10-16,Incentive,41009,D,285464
488540177,2017-11-02,Other,5592,D,291056
488540177,2017-11-15,Friend,38581,D,329637
488540177,2017-11-18,Online-Shopping,30445,W,299192
488540177,2017-11-18,Friend,37830,D,337022
488540177,2017-12-01,Credit-bill,2316,W,334706
488540177,2017-12-03,Rent-payment,10258,W,324448
488540177,2017-12-10,Bank-transfered,45729,W,278719
488540177,2018-01-01,Bank-transfered,2936,W,275783
488540177,2018-01-05,Credit-bill,19715,W,256068
488540177,2018-01-11,Other,44410,D,300478
488540177,2018-01-18,Online-Shopping,43989,W,256489
488540177,2018-01-21,Other,48756,D,305245
488540177,2018-01-21,Friend,11440,D,316685
488540177,2018-01-26,Fuel,25082,W,291603
488540177,2018-01-27,Other,6907,D,298510
488540177,2018-02-01,Bank-transfered,27188,W,271322
488540177,2018-02-02,Credit-bill,37326,W,233996
488540177,2018-02-04,Other,46492,W,187504
488540177,2018-02-05,Friend,9000,D,196504
488540177,2018-02-13,Other,42012,W,154492
488540177,2018-02-13,Bank-transfered,11026,W,143466
488540177,2018-02-13,Credit-bill,12822,W,130644
488540177,2018-02-24,Incentive,13838,D,144482
488540177,2018-03-01,Salary,9058,D,153540
488540177,2018-03-01,Friend,2638,D,156178
488540177,2018-03-08,Incentive,29535,D,185713
488540177,2018-03-13,Credit-bill,31679,W,154034
488540177,2018-03-19,Salary,43505,D,197539
488540177,2018-04-05,Credit-bill,33609,W,163930
488540177,2018-04-11,Fuel,14798,W,149132
488540177,2018-04-16,Other,32416,D,181548
488540177,2018-04-21,Fuel,40792,W,140756
488540177,2018-04-25,Incentive,22726,D,163482
488540177,2018-04-25,Other,43453,D,206935
488540177,2018-05-04,Other,5625,W,201310
488540177,2018-05-07,Friend,16795,D,218105
488540177,2018-05-21,Other,36054,D,254159
488540177,2018-06-08,Friend,13264,D,267423
488540177,2018-06-10,Fuel,13299,W,254124
488540177,2018-06-17,Friend,33597,D,287721
488540177,2018-06-22,Other,37260,D,324981
488540177,2018-06-25,Incentive,21814,D,346795
488540177,2018-06-28,Online-Shopping,2607,W,344188
488540177,2018-07-06,Credit-bill,3949,W,340239
488540177,2018-07-12,Online-Shopping,38540,W,301699
488540177,2018-07-12,Salary,43818,D,345517
488540177,2018-07-15,Incentive,17578,D,363095
488540177,2018-07-16,Incentive,34849,D,397944
488540177,2018-07-18,Other,40898,D,438842
488540177,2018-07-26,Rent-payment,32674,W,406168
488540177,2018-07-29,Incentive,22357,D,428525
488540177,2018-07-31,Incentive,41881,D,470406
488540177,2018-08-04,Other,21205,D,491611
488540177,2018-08-13,Rent-payment,8265,W,483346
488540177,2018-08-27,Salary,21698,D,505044
488540177,2018-09-06,Other,7384,W,497660
488540177,2018-09-08,Salary,37929,D,535589
488540177,2018-09-11,Online-Shopping,36498,W,499091
488540177,2018-09-23,Credit-bill,7137,W,491954
488540177,2018-09-26,Credit-bill,49835,W,442119
488540177,2018-09-29,Other,22019,W,420100
488540177,2018-10-07,Friend,37667,D,457767
488540177,2018-10-21,Online-Shopping,7986,W,449781
488540177,2018-10-22,Incentive,35438,D,485219
488540177,2018-10-24,Other,36631,D,521850
488540177,2018-10-25,Other,47590,D,569440
488540177,2018-10-28,Bank-transfered,37605,W,531835
488540177,2018-11-01,Other,27250,D,559085
488540177,2018-11-24,Credit-bill,25253,W,533832
488540177,2018-11-26,Bank-transfered,35051,W,498781
488540177,2018-12-02,Rent-payment,25546,W,473235
488540177,2018-12-06,Other,18669,W,454566
488540177,2018-12-09,Other,5166,D,459732
488540177,2018-12-22,Rent-payment,21106,W,438626
488540177,2018-12-29,Rent-payment,25836,W,412790
488540177,2019-01-01,Other,14320,D,427110
488540177,2019-01-01,Incentive,22801,D,449911
488540177,2019-01-04,Other,14834,D,464745
488540177,2019-01-13,Fuel,24634,W,440111
488540177,2019-01-14,Other,11176,W,428935
488540177,2019-01-17,Incentive,13650,D,442585
488540177,2019-01-23,Incentive,34144,D,476729
488540177,2019-01-30,Other,44882,D,521611
488540177,2019-01-31,Bank-transfered,49674,W,471937
488540177,2019-02-19,Rent-payment,38323,W,433614
488540177,2019-02-20,Online-Shopping,9292,W,424322
488540177,2019-02-25,Rent-payment,36118,W,388204
488540177,2019-02-26,Online-Shopping,7939,W,380265
488540177,2019-03-04,Bank-transfered,3873,W,376392
488540177,2019-03-11,Incentive,14616,D,391008
488540177,2019-03-15,Friend,46073,D,437081
488540177,2019-03-15,Salary,26835,D,463916
488540177,2019-03-21,Incentive,24274,D,488190
488540177,2019-03-31,Bank-transfered,10472,W,477718
488540177,2019-04-02,Fuel,18926,W,458792
488540177,2019-04-06,Salary,6360,D,465152
488540177,2019-04-22,Incentive,23176,D,488328
488540177,2019-04-29,Friend,24322,D,512650
488540177,2019-05-17,Rent-payment,10205,W,502445
488540177,2019-05-18,Other,29841,D,532286
488540177,2019-05-20,Online-Shopping,32391,W,499895
488540177,2019-05-26,Salary,35909,D,535804
488540177,2019-05-28,Incentive,31878,D,567682
488540177,2019-06-01,Bank-transfered,43465,W,524217
488540177,2019-06-06,Incentive,30740,D,554957
488540177,2019-06-12,Rent-payment,12029,W,542928
488540177,2019-06-17,Incentive,48901,D,591829
488540177,2019-06-30,Incentive,14460,D,606289
488540177,2019-07-03,Salary,39264,D,645553
488540177,2019-07-06,Fuel,17011,W,628542
488540177,2019-07-08,Incentive,6064,D,634606
488540177,2019-07-14,Credit-bill,8808,W,625798
488540177,2019-07-16,Other,10674,W,615124
488540177,2019-07-22,Other,7000,D,622124
488540177,2019-07-23,Bank-transfered,1724,W,620400
488540177,2019-07-27,Friend,10811,D,631211
488540177,2019-08-06,Fuel,32547,W,598664
488540177,2019-08-18,Rent-payment,13469,W,585195
488540177,2019-08-20,Other,11175,D,596370
488540177,2019-09-04,Incentive,39722,D,636092
488540177,2019-09-28,Salary,25804,D,661896
488540177,2019-09-29,Salary,30967,D,692863
488540177,2019-10-03,Online-Shopping,26739,W,666124
488540177,2019-10-05,Bank-transfered,35028,W,631096
488540177,2019-10-14,Friend,14652,D,645748
488540177,2019-10-16,Fuel,27236,W,618512
488540177,2019-10-30,Rent-payment,19150,W,599362
488540177,2019-10-30,Salary,7603,D,606965
488540177,2019-11-04,Friend,17354,D,624319
488540177,2019-11-07,Salary,23784,D,648103
488540177,2019-11-11,Bank-transfered,17061,W,631042
488540177,2019-11-17,Other,9482,D,640524
488540177,2019-11-20,Friend,35385,D,675909
488540177,2019-12-13,Other,11965,W,663944
488540177,2019-12-15,Other,29300,D,693244
488540177,2020-01-05,Friend,30955,D,724199
488540177,2020-01-10,Online-Shopping,48076,W,676123
488540177,2020-01-28,Friend,2954,D,679077
488540177,2020-02-10,Bank-transfered,35512,W,643565
488540177,2020-02-22,Other,29354,D,672919
488540177,2020-03-10,Incentive,39104,D,712023
488540177,2020-03-17,Bank-transfered,10562,W,701461
488540177,2020-03-18,Friend,8394,D,709855
488540177,2020-03-23,Bank-transfered,25910,W,683945
488540177,2020-03-26,Friend,44788,D,728733
488540177,2020-03-27,Bank-transfered,45453,W,683280
488540177,2020-03-28,Bank-transfered,10853,W,672427
488540177,2020-03-31,Other,21480,D,693907
488540177,2020-04-05,Friend,4303,D,698210
488540177,2020-04-08,Rent-payment,18957,W,679253
488540177,2020-04-09,Bank-transfered,22432,W,656821
488540177,2020-04-09,Incentive,25559,D,682380
488540177,2020-04-10,Credit-bill,49887,W,632493
488540177,2020-04-13,Rent-payment,21513,W,610980
488540177,2020-04-17,Online-Shopping,45276,W,565704
488540177,2020-04-27,Other,48951,D,614655
488540177,2020-05-02,Incentive,6426,D,621081
488540177,2020-05-09,Friend,28999,D,650080
488540177,2020-05-14,Other,10468,W,639612
488540177,2020-05-15,Other,10368,D,649980
488540177,2020-05-22,Salary,24993,D,674973
488540177,2020-05-25,Credit-bill,48111,W,626862
488540177,2020-06-05,Rent-payment,24265,W,602597
488540177,2020-06-11,Fuel,11023,W,591574
488540177,2020-06-22,Other,15176,D,606750
488540177,2020-06-23,Salary,35130,D,641880
488540177,2020-06-30,Salary,20902,D,662782
488540177,2020-07-04,Incentive,30268,D,693050
488540177,2020-07-14,Rent-payment,30782,W,662268
488540177,2020-07-15,Bank-transfered,3519,W,658749
488540177,2020-07-15,Friend,46827,D,705576
488540177,2020-07-18,Bank-transfered,7104,W,698472
488540177,2020-08-02,Fuel,44750,W,653722
488540177,2020-08-09,Online-Shopping,25537,W,628185
488540177,2020-08-20,Salary,31876,D,660061
488540177,2020-08-22,Incentive,41053,D,701114
488540177,2020-08-30,Credit-bill,3607,W,697507
488540177,2020-09-14,Friend,37832,D,735339
488540177,2020-09-22,Salary,40312,D,775651
488540177,2020-10-16,Bank-transfered,30047,W,745604
488540177,2020-10-21,Online-Shopping,19721,W,725883
488540177,2020-10-23,Fuel,35376,W,690507
488540177,2020-10-24,Incentive,47892,D,738399
488540177,2020-10-31,Other,37386,W,701013
488540177,2020-11-01,Salary,36467,D,737480
488540177,2020-11-01,Other,43205,D,780685
488540177,2020-11-07,Fuel,20405,W,760280
488540177,2020-11-19,Online-Shopping,17954,W,742326
488540177,2020-11-26,Other,36033,D,778359
488540177,2020-11-27,Credit-bill,3175,W,775184
488540177,2021-01-23,Friend,15537,D,790721
488540177,2021-02-01,Incentive,28472,D,819193
488540177,2021-02-03,Salary,49631,D,868824
488540177,2021-02-03,Friend,16370,D,885194
488540177,2021-02-06,Bank-transfered,21254,W,863940
488540177,2021-02-07,Other,43910,D,907850
488540177,2021-02-08,Other,41629,D,949479
488540177,2021-02-15,Online-Shopping,7673,W,941806
488540177,2021-02-23,Rent-payment,45940,W,895866
488540177,2021-02-26,Fuel,7861,W,888005
488540177,2021-03-09,Friend,1091,D,889096
488540177,2021-03-22,Online-Shopping,46793,W,842303
488540177,2021-04-04,Friend,9489,D,851792
488540177,2021-04-10,Other,10370,D,862162
488540177,2021-04-13,Other,11777,D,873939
488540177,2021-04-14,Other,5174,W,868765
488540177,2021-04-18,Rent-payment,34388,W,834377
488540177,2021-04-23,Other,2934,D,837311
488540177,2021-04-30,Credit-bill,41652,W,795659
488540177,2021-05-01,Incentive,3247,D,798906
488540177,2021-05-01,Other,22484,D,821390
488540177,2021-05-08,Salary,21454,D,842844
488540177,2021-05-10,Credit-bill,14337,W,828507
488540177,2021-05-28,Rent-payment,7581,W,820926
488540177,2021-05-29,Incentive,26128,D,847054
488540177,2021-06-08,Other,3391,D,850445
488540177,2021-06-19,Incentive,31098,D,881543
488540177,2021-06-22,Salary,39024,D,920567
488540177,2021-06-24,Friend,24433,D,945000
488540177,2021-07-04,Bank-transfered,6416,W,938584
488540177,2021-07-10,Fuel,43386,W,895198
488540177,2021-07-17,Salary,1580,D,896778
488540177,2021-07-24,Salary,6786,D,903564
488540177,2021-08-03,Other,4616,D,908180
488540177,2021-08-07,Fuel,6489,W,901691
488540177,2021-08-21,Salary,18525,D,920216
488540177,2021-08-23,Friend,39142,D,959358
488540177,2021-09-04,Salary,35026,D,994384
488540177,2021-09-11,Other,48544,W,945840
488540177,2021-09-13,Rent-payment,18612,W,927228
488540177,2021-09-26,Fuel,26342,W,900886
488540177,2021-10-01,Online-Shopping,42687,W,858199
488540177,2021-10-02,Other,1058,D,859257
488540177,2021-10-27,Credit-bill,49254,W,810003
488540177,2021-10-31,Salary,6186,D,816189
488540177,2021-11-10,Friend,32509,D,848698
488540177,2021-11-10,Salary,49647,D,898345
488540177,2021-11-10,Credit-bill,41545,W,856800
488540177,2021-11-12,Friend,8705,D,865505
488540177,2021-11-28,Other,22976,D,888481
488540177,2021-11-30,Fuel,21811,W,866670
488540177,2021-12-20,Salary,37503,D,904173
488540177,2021-12-20,Rent-payment,44513,W,859660
488540177,2021-12-27,Rent-payment,49305,W,810355
279806772,2017-01-20,Credit-bill,33814,W,239709
279806772,2017-01-25,Rent-payment,22798,W,216911
279806772,2017-02-06,Friend,31353,D,248264
279806772,2017-02-09,Other,38705,W,209559
279806772,2017-02-17,Bank-transfered,38263,W,171296
279806772,2017-02-17,Incentive,38108,D,209404
279806772,2017-02-24,Credit-bill,16494,W,192910
279806772,2017-02-28,Friend,41757,D,234667
279806772,2017-03-02,Rent-payment,39995,W,194672
279806772,2017-03-02,Salary,27634,D,222306
279806772,2017-03-03,Other,11419,W,210887
279806772,2017-03-14,Online-Shopping,38950,W,171937
279806772,2017-03-14,Other,36819,D,208756
279806772,2017-04-02,Friend,40232,D,248988
279806772,2017-04-08,Rent-payment,13785,W,235203
279806772,2017-04-11,Salary,30483,D,265686
279806772,2017-04-14,Fuel,34353,W,231333
279806772,2017-04-23,Incentive,17575,D,248908
279806772,2017-04-27,Credit-bill,11842,W,237066
279806772,2017-04-30,Rent-payment,32401,W,204665
279806772,2017-05-15,Bank-transfered,47490,W,157175
279806772,2017-05-24,Other,14885,D,172060
279806772,2017-05-31,Credit-bill,42191,W,129869
279806772,2017-06-01,Fuel,23767,W,106102
279806772,2017-06-07,Friend,3955,D,110057
279806772,2017-06-11,Other,35872,W,74185
279806772,2017-06-12,Friend,37807,D,111992
279806772,2017-06-20,Bank-transfered,1734,W,110258
279806772,2017-06-20,Other,43472,W,66786
279806772,2017-06-25,Rent-payment,15711,W,51075
279806772,2017-06-26,Rent-payment,6674,W,44401
279806772,2017-07-20,Salary,41479,D,85880
279806772,2017-07-25,Incentive,40158,D,126038
279806772,2017-08-07,Fuel,8087,W,117951
279806772,2017-08-09,Other,30611,D,148562
279806772,2017-08-15,Friend,5079,D,153641
279806772,2017-08-17,Incentive,33680,D,187321
279806772,2017-08-28,Rent-payment,27040,W,160281
279806772,2017-08-30,Other,3044,W,157237
279806772,2017-09-02,Credit-bill,11610,W,145627
279806772,2017-09-11,Salary,21173,D,166800
279806772,2017-09-16,Credit-bill,46560,W,120240
279806772,2017-09-19,Credit-bill,35382,W,84858
279806772,2017-09-20,Incentive,16563,D,101421
279806772,2017-09-25,Fuel,16616,W,84805
279806772,2017-09-28,Salary,33422,D,118227
279806772,2017-10-03,Salary,30038,D,148265
279806772,2017-10-09,Other,33984,D,182249
279806772,2017-10-11,Friend,49080,D,231329
279806772,2017-10-12,Other,49153,D,280482
279806772,2017-10-14,Incentive,11654,D,292136
279806772,2017-10-20,Incentive,30048,D,322184
279806772,2017-10-24,Other,3775,D,325959
279806772,2017-11-02,Bank-transfered,13677,W,312282
279806772,2017-11-04,Incentive,47816,D,360098
279806772,2017-11-07,Friend,5706,D,365804
279806772,2017-11-16,Incentive,33230,D,399034
279806772,2017-11-17,Friend,4914,D,403948
279806772,2017-11-18,Incentive,41016,D,444964
279806772,2017-11-19,Rent-payment,3813,W,441151
279806772,2017-11-24,Other,14812,D,455963
279806772,2017-12-08,Credit-bill,4076,W,451887
279806772,2017-12-12,Online-Shopping,16023,W,435864
279806772,2017-12-16,Other,41667,D,477531
279806772,2018-01-02,Salary,49639,D,527170
279806772,2018-01-03,Salary,24105,D,551275
279806772,2018-01-18,Friend,48760,D,600035
279806772,2018-01-28,Other,20046,W,579989
279806772,2018-02-03,Fuel,2101,W,577888
279806772,2018-02-07,Salary,44910,D,622798
279806772,2018-02-10,Friend,3215,D,626013
279806772,2018-02-15,Other,36170,D,662183
279806772,2018-02-19,Friend,26301,D,688484
279806772,2018-02-23,Other,25245,D,713729
279806772,2018-03-02,Online-Shopping,13436,W,700293
279806772,2018-03-15,Incentive,40323,D,740616
279806772,2018-03-21,Friend,26482,D,767098
279806772,2018-03-25,Credit-bill,9106,W,757992
279806772,2018-03-31,Other,24690,D,782682
279806772,2018-04-04,Incentive,49219,D,831901
279806772,2018-04-05,Friend,1046,D,832947
279806772,2018-04-11,Incentive,1113,D,834060
279806772,2018-04-20,Other,44796,D,878856
279806772,2018-05-04,Credit-bill,48136,W,830720
279806772,2018-05-09,Friend,1784,D,832504
279806772,2018-05-26,Salary,49044,D,881548
279806772,2018-05-28,Fuel,42812,W,838736
279806772,2018-06-05,Online-Shopping,2805,W,835931
279806772,2018-06-09,Bank-transfered,39293,W,796638
279806772,2018-06-12,Fuel,22467,W,774171
279806772,2018-06-24,Online-Shopping,49309,W,724862
279806772,2018-07-07,Credit-bill,41877,W,682985
279806772,2018-07-11,Other,3306,D,686291
279806772,2018-07-22,Other,7160,D,693451
279806772,2018-07-23,Other,47327,D,740778
279806772,2018-07-25,Salary,35366,D,776144
279806772,2018-07-28,Other,32485,D,808629
279806772,2018-08-08,Other,33810,W,774819
279806772,2018-08-22,Rent-payment,33603,W,741216
279806772,2018-08-22,Fuel,5365,W,735851
279806772,2018-09-01,Fuel,7648,W,728203
279806772,2018-09-04,Other,49227,D,777430
279806772,2018-09-23,Incentive,24810,D,802240
279806772,2018-09-24,Online-Shopping,24068,W,778172
279806772,2018-09-26,Other,22437,D,800609
279806772,2018-09-28,Rent-payment,4954,W,795655
279806772,2018-10-03,Incentive,36198,D,831853
279806772,2018-10-07,Salary,49950,D,881803
279806772,2018-10-08,Salary,3017,D,884820
279806772,2018-10-10,Other,22707,D,907527
279806772,2018-10-12,Other,24551,D,932078
279806772,2018-10-13,Friend,35499,D,967577
279806772,2018-10-14,Other,14126,D,981703
279806772,2018-10-20,Friend,17354,D,999057
279806772,2018-11-12,Other,46103,W,952954
279806772,2018-11-19,Incentive,40934,D,993888
279806772,2018-11-23,Other,38920,D,1032808
279806772,2018-11-28,Incentive,11943,D,1044751
279806772,2018-12-07,Online-Shopping,23090,W,1021661
279806772,2018-12-08,Incentive,23476,D,1045137
279806772,2018-12-14,Other,34210,W,1010927
279806772,2019-01-07,Bank-transfered,3437,W,1007490
279806772,2019-01-27,Online-Shopping,3544,W,1003946
279806772,2019-01-27,Rent-payment,15454,W,988492
279806772,2019-02-03,Salary,25957,D,1014449
279806772,2019-02-05,Incentive,15927,D,1030376
279806772,2019-02-05,Incentive,31648,D,1062024
279806772,2019-02-06,Other,4940,D,1066964
279806772,2019-02-12,Rent-payment,23329,W,1043635
279806772,2019-02-13,Salary,31741,D,1075376
279806772,2019-02-16,Online-Shopping,11714,W,1063662
279806772,2019-02-18,Friend,10847,D,1074509
279806772,2019-03-07,Other,20158,W,1054351
279806772,2019-03-07,Other,11042,W,1043309
279806772,2019-03-11,Other,19553,D,1062862
279806772,2019-03-17,Friend,8016,D,1070878
279806772,2019-03-22,Bank-transfered,46259,W,1024619
279806772,2019-03-26,Incentive,45439,D,1070058
279806772,2019-03-28,Incentive,18028,D,1088086
279806772,2019-04-02,Bank-transfered,17859,W,1070227
279806772,2019-04-03,Incentive,37452,D,1107679
279806772,2019-04-03,Fuel,12958,W,1094721
279806772,2019-04-14,Online-Shopping,43366,W,1051355
279806772,2019-04-20,Bank-transfered,8946,W,1042409
279806772,2019-04-22,Bank-transfered,6998,W,1035411
279806772,2019-04-25,Other,5625,W,1029786
279806772,2019-05-09,Friend,47172,D,1076958
279806772,2019-05-21,Friend,43251,D,1120209
279806772,2019-06-04,Incentive,46878,D,1167087
279806772,2019-06-18,Other,1226,D,1168313
279806772,2019-06-23,Other,18215,D,1186528
279806772,2019-06-27,Other,32460,W,1154068
279806772,2019-06-29,Bank-transfered,21702,W,1132366
279806772,2019-07-02,Incentive,12904,D,1145270
279806772,2019-07-03,Friend,42906,D,1188176
279806772,2019-07-05,Incentive,25819,D,1213995
279806772,2019-07-09,Credit-bill,17773,W,1196222
279806772,2019-07-27,Credit-bill,11537,W,1184685
279806772,2019-08-10,Incentive,2131,D,1186816
279806772,2019-08-29,Incentive,8595,D,1195411
279806772,2019-09-12,Salary,1114,D,1196525
279806772,2019-09-19,Incentive,39416,D,1235941
279806772,2019-09-22,Other,18094,D,1254035
279806772,2019-10-07,Other,6067,D,1260102
279806772,2019-10-08,Fuel,26420,W,1233682
279806772,2019-10-28,Friend,5083,D,1238765
279806772,2019-11-03,Friend,28774,D,1267539
279806772,2019-12-07,Other,49307,D,1316846
279806772,2019-12-17,Other,7890,D,1324736
279806772,2019-12-21,Salary,43980,D,1368716
279806772,2019-12-22,Rent-payment,15558,W,1353158
279806772,2019-12-26,Incentive,44880,D,1398038
279806772,2020-01-13,Salary,16584,D,1414622
279806772,2020-01-17,Fuel,47308,W,1367314
279806772,2020-01-27,Incentive,33962,D,1401276
279806772,2020-01-27,Incentive,38145,D,1439421
279806772,2020-02-01,Rent-payment,16309,W,1423112
279806772,2020-02-01,Rent-payment,14662,W,1408450
279806772,2020-02-16,Incentive,17912,D,1426362
279806772,2020-02-19,Bank-transfered,2271,W,1424091
279806772,2020-02-25,Friend,19251,D,1443342
279806772,2020-03-05,Other,4988,D,1448330
279806772,2020-03-06,Other,49533,D,1497863
279806772,2020-03-07,Friend,48196,D,1546059
279806772,2020-03-10,Credit-bill,36502,W,1509557
279806772,2020-03-10,Salary,22908,D,1532465
279806772,2020-03-28,Other,29792,D,1562257
279806772,2020-03-28,Incentive,26144,D,1588401
279806772,2020-03-31,Credit-bill,1529,W,1586872
279806772,2020-04-07,Incentive,15971,D,1602843
279806772,2020-04-13,Other,27972,W,1574871
279806772,2020-04-21,Other,3267,D,1578138
279806772,2020-04-23,Online-Shopping,1380,W,1576758
279806772,2020-04-23,Other,11587,W,1565171
279806772,2020-05-10,Other,23287,D,1588458
279806772,2020-05-14,Friend,1099,D,1589557
279806772,2020-05-15,Online-Shopping,46239,W,1543318
279806772,2020-05-25,Fuel,37803,W,1505515
279806772,2020-05-28,Bank-transfered,23085,W,1482430
279806772,2020-05-31,Salary,21340,D,1503770
279806772,2020-06-07,Friend,17918,D,1521688
279806772,2020-06-11,Fuel,22198,W,1499490
279806772,2020-06-25,Other,6150,D,1505640
279806772,2020-07-09,Incentive,43871,D,1549511
279806772,2020-07-20,Credit-bill,11419,W,1538092
279806772,2020-07-24,Online-Shopping,6639,W,1531453
279806772,2020-07-25,Friend,19413,D,1550866
279806772,2020-07-27,Credit-bill,6610,W,1544256
279806772,2020-07-27,Salary,12705,D,1556961
279806772,2020-08-31,Rent-payment,47952,W,1509009
279806772,2020-09-07,Friend,47619,D,1556628
279806772,2020-09-14,Other,14504,D,1571132
279806772,2020-09-18,Online-Shopping,8789,W,1562343
279806772,2020-09-20,Other,13500,D,1575843
279806772,2020-09-26,Friend,29248,D,1605091
279806772,2020-10-02,Rent-payment,17634,W,1587457
279806772,2020-10-06,Credit-bill,6122,W,1581335
279806772,2020-10-12,Friend,34235,D,1615570
279806772,2020-10-15,Credit-bill,37756,W,1577814
279806772,2020-10-17,Credit-bill,49622,W,1528192
279806772,2020-10-21,Online-Shopping,35360,W,1492832
279806772,2020-10-23,Online-Shopping,33642,W,1459190
279806772,2020-10-24,Incentive,30393,D,1489583
279806772,2020-11-02,Credit-bill,26579,W,1463004
279806772,2020-11-08,Friend,1160,D,1464164
279806772,2020-11-18,Rent-payment,1414,W,1462750
279806772,2020-11-24,Rent-payment,25585,W,1437165
279806772,2020-11-26,Incentive,38941,D,1476106
279806772,2020-12-04,Bank-transfered,48339,W,1427767
279806772,2020-12-11,Incentive,45323,D,1473090
279806772,2020-12-28,Incentive,30766,D,1503856
279806772,2021-01-01,Other,10057,D,1513913
279806772,2021-01-08,Salary,5817,D,1519730
279806772,2021-01-09,Bank-transfered,19323,W,1500407
279806772,2021-01-10,Incentive,46812,D,1547219
279806772,2021-01-15,Credit-bill,14871,W,1532348
279806772,2021-01-22,Other,31110,D,1563458
279806772,2021-01-27,Online-Shopping,37020,W,1526438
279806772,2021-01-28,Rent-payment,4692,W,1521746
279806772,2021-02-02,Incentive,43591,D,1565337
279806772,2021-02-11,Other,14390,W,1550947
279806772,2021-02-17,Salary,36562,D,1587509
279806772,2021-02-23,Other,49467,D,1636976
279806772,2021-03-01,Bank-transfered,14407,W,1622569
279806772,2021-03-07,Online-Shopping,36602,W,1585967
279806772,2021-03-28,Rent-payment,7666,W,1578301
279806772,2021-04-05,Friend,39632,D,1617933
279806772,2021-04-11,Bank-transfered,45055,W,1572878
279806772,2021-04-15,Other,35621,D,1608499
279806772,2021-04-16,Friend,6436,D,1614935
279806772,2021-04-25,Rent-payment,46582,W,1568353
279806772,2021-05-02,Other,25312,D,1593665
279806772,2021-05-17,Online-Shopping,33611,W,1560054
279806772,2021-05-18,Credit-bill,35250,W,1524804
279806772,2021-05-23,Credit-bill,49295,W,1475509
279806772,2021-06-09,Salary,45364,D,1520873
279806772,2021-06-17,Rent-payment,28113,W,1492760
279806772,2021-06-20,Incentive,35991,D,1528751
279806772,2021-07-01,Incentive,16112,D,1544863
279806772,2021-07-13,Other,18733,W,1526130
279806772,2021-07-17,Rent-payment,49181,W,1476949
279806772,2021-07-22,Fuel,44526,W,1432423
279806772,2021-07-24,Other,21416,D,1453839
279806772,2021-07-27,Incentive,44696,D,1498535
279806772,2021-08-13,Credit-bill,29357,W,1469178
279806772,2021-08-15,Friend,49123,D,1518301
279806772,2021-09-04,Other,48886,D,1567187
279806772,2021-09-05,Online-Shopping,42536,W,1524651
279806772,2021-09-23,Credit-bill,19967,W,1504684
279806772,2021-09-28,Salary,45391,D,1550075
279806772,2021-10-18,Other,27609,D,1577684
279806772,2021-10-20,Incentive,21561,D,1599245
279806772,2021-10-21,Online-Shopping,4250,W,1594995
279806772,2021-10-23,Other,26343,D,1621338
279806772,2021-10-30,Fuel,9130,W,1612208
279806772,2021-11-06,Online-Shopping,3871,W,1608337
279806772,2021-11-20,Incentive,11538,D,1619875
279806772,2021-11-20,Fuel,44587,W,1575288
279806772,2021-12-08,Other,29817,W,1545471
279806772,2021-12-15,Rent-payment,17254,W,1528217
279806772,2021-12-30,Incentive,5298,D,1533515
